103 3.2 0 -1
101 0.96 -0.96 -1
101 1.28 -0.96 -1
101 -1.6 -1.28 -1
101 -2.24 -1.28 -1
101 -3.2 -1.28 -1
101 -4.16 0.32 -1
101 -4.16 -0.32 -1
101 -4.16 0 -1
101 4.16 -1.92 -1
101 4.16 -1.6 -1
101 4.16 0 -1
101 -3.84 1.92 -1
101 -4.16 -1.6 -1
101 -4.16 -0.64 -1
101 4.16 0.64 -1
101 4.16 0.32 -1
101 4.16 -1.28 -1
101 4.16 -0.96 -1
101 4.16 -0.32 -1
101 4.16 -0.64 -1
101 3.2 -1.92 -1
101 -4.16 -1.28 -1
101 -4.16 -0.96 -1
101 0.96 1.92 -1
101 -3.52 1.92 -1
101 -3.2 1.92 -1
101 -2.88 1.92 -1
101 -2.56 1.92 -1
101 -2.24 1.92 -1
101 -1.92 1.92 -1
101 -1.6 1.92 -1
101 -1.28 1.92 -1
101 -0.96 1.92 -1
101 -0.64 1.92 -1
101 -0.32 1.92 -1
101 0 1.92 -1
101 0.32 1.92 -1
101 0.64 1.92 -1
101 -4.16 0.64 -1
101 -4.16 0.96 -1
101 -4.16 1.28 -1
101 -4.16 1.6 -1
101 -4.16 1.92 -1
101 1.28 1.92 -1
101 1.6 1.92 -1
101 1.92 1.92 -1
101 2.24 1.92 -1
101 2.56 1.92 -1
101 2.88 1.92 -1
101 3.2 1.92 -1
101 3.52 1.92 -1
101 3.84 1.92 -1
101 4.16 1.92 -1
101 4.16 1.6 -1
101 4.16 1.28 -1
101 4.16 0.96 -1
101 -4.16 -1.92 -1
101 -3.52 -1.92 -1
101 -3.84 -1.92 -1
101 -2.56 -1.92 -1
101 -1.92 -1.92 -1
101 -1.28 -1.92 -1
101 -0.32 -1.92 -1
101 0.32 -1.92 -1
101 0.64 -1.92 -1
101 1.28 -1.92 -1
101 1.92 -1.92 -1
101 2.88 -1.92 -1
101 2.56 -1.92 -1
101 2.24 -1.92 -1
101 1.6 -1.92 -1
101 0.96 -1.92 -1
101 0 -1.92 -1
101 -0.64 -1.92 -1
101 -0.96 -1.92 -1
101 -1.6 -1.92 -1
101 -2.24 -1.92 -1
101 -2.88 -1.92 -1
101 -3.2 -1.92 -1
101 3.84 -1.92 -1
101 3.52 -1.92 -1
3 -3.52 -1.28 0
3 -1.92 -1.28 0
101 -4.8 -2.56 -1
101 3.84 -0.32 -1
3 1.6 -0.96 0
3 3.2 -0.32 0
101 -4.48 1.92 -1
101 -4.48 1.6 -1
101 -4.48 1.28 -1
101 -4.48 0.96 -1
101 -4.48 0.64 -1
101 -4.48 0.32 -1
101 -4.48 0 -1
101 -4.48 -0.32 -1
101 -4.48 -0.64 -1
101 -4.48 -0.96 -1
101 -4.48 -1.28 -1
101 -4.48 -1.6 -1
101 -4.48 -1.92 -1
101 -4.48 -2.24 -1
101 -4.16 -2.24 -1
101 -3.84 -2.24 -1
101 -3.52 -2.24 -1
101 -3.2 -2.24 -1
101 -2.88 -2.24 -1
101 -2.56 -2.24 -1
101 -2.24 -2.24 -1
101 -1.92 -2.24 -1
101 -1.6 -2.24 -1
101 -1.28 -2.24 -1
101 -0.96 -2.24 -1
101 -0.64 -2.24 -1
101 -0.32 -2.24 -1
101 0 -2.24 -1
101 0.32 -2.24 -1
101 0.64 -2.24 -1
101 0.96 -2.24 -1
101 1.28 -2.24 -1
101 1.6 -2.24 -1
101 1.92 -2.24 -1
101 2.24 -2.24 -1
101 2.56 -2.24 -1
101 2.88 -2.24 -1
101 3.2 -2.24 -1
101 3.52 -2.24 -1
101 3.84 -2.24 -1
101 4.16 -2.24 -1
101 4.48 1.92 -1
101 4.48 1.6 -1
101 4.48 1.28 -1
101 4.48 0.96 -1
101 4.48 0.64 -1
101 4.48 0.32 -1
101 4.48 0 -1
101 4.48 -0.32 -1
101 4.48 -0.64 -1
101 4.48 -0.96 -1
101 4.48 -1.28 -1
101 4.48 -1.6 -1
101 4.48 -1.92 -1
101 4.48 -2.24 -1
101 -4.48 2.24 -1
101 -4.16 2.24 -1
101 -3.84 2.24 -1
101 -3.52 2.24 -1
101 -3.2 2.24 -1
101 -2.88 2.24 -1
101 -2.56 2.24 -1
101 -2.24 2.24 -1
101 -1.92 2.24 -1
101 -1.6 2.24 -1
101 -1.28 2.24 -1
101 -0.96 2.24 -1
101 -0.64 2.24 -1
101 -0.32 2.24 -1
101 0 2.24 -1
101 0.32 2.24 -1
100 -3.52 -0.9599 1
101 0.64 2.24 -1
101 0.96 2.24 -1
101 1.28 2.24 -1
101 1.6 2.24 -1
101 1.92 2.24 -1
101 2.24 2.24 -1
101 2.56 2.24 -1
101 2.88 2.24 -1
101 3.52 2.24 -1
101 3.84 2.24 -1
101 4.16 2.24 -1
101 4.48 2.24 -1
101 -4.48 -2.56 -1
101 -4.16 -2.56 -1
101 -3.84 -2.56 -1
101 -3.52 -2.56 -1
101 -3.2 -2.56 -1
101 -2.88 -2.56 -1
101 -2.56 -2.56 -1
101 -2.24 -2.56 -1
101 -1.92 -2.56 -1
101 -1.6 -2.56 -1
101 -1.28 -2.56 -1
101 -0.96 -2.56 -1
101 -0.64 -2.56 -1
101 -0.32 -2.56 -1
101 0 -2.56 -1
101 0.32 -2.56 -1
101 0.64 -2.56 -1
101 0.96 -2.56 -1
101 1.28 -2.56 -1
101 1.6 -2.56 -1
101 1.92 -2.56 -1
101 2.24 -2.56 -1
101 2.56 -2.56 -1
101 2.88 -2.56 -1
101 3.2 -2.56 -1
101 3.52 -2.56 -1
101 3.84 -2.56 -1
101 4.16 -2.56 -1
101 4.48 -2.56 -1
101 4.8 2.24 -1
101 4.8 1.92 -1
101 4.8 1.6 -1
101 4.8 1.28 -1
101 4.8 0.96 -1
101 4.8 0.64 -1
101 4.8 0.32 -1
101 4.8 0 -1
101 4.8 -0.32 -1
101 4.8 -0.64 -1
101 4.8 -0.96 -1
101 4.8 -1.28 -1
101 4.8 -1.6 -1
101 4.8 -1.92 -1
101 4.8 -2.24 -1
101 4.8 -2.56 -1
101 -4.48 2.56 -1
101 -4.16 2.56 -1
101 -3.84 2.56 -1
101 -3.52 2.56 -1
101 -3.2 2.56 -1
101 -2.88 2.56 -1
101 -2.56 2.56 -1
101 -2.24 2.56 -1
101 -1.92 2.56 -1
101 -1.6 2.56 -1
101 -1.28 2.56 -1
101 -0.96 2.56 -1
101 -0.64 2.56 -1
101 -0.32 2.56 -1
101 0 2.56 -1
101 0.32 2.56 -1
101 3.2 2.24 -1
101 3.52 2.56 -1
101 3.84 2.56 -1
101 4.16 2.56 -1
101 4.48 2.56 -1
101 4.8 2.56 -1
101 3.2 2.56 -1
101 2.88 2.56 -1
101 2.56 2.56 -1
101 2.24 2.56 -1
101 1.92 2.56 -1
101 1.6 2.56 -1
101 1.28 2.56 -1
101 0.64 2.56 -1
101 -4.8 2.56 -1
101 -4.8 2.24 -1
101 -4.8 1.92 -1
101 -4.8 1.6 -1
101 -4.8 1.28 -1
101 -4.8 0.96 -1
101 -4.8 0.64 -1
101 -4.8 0.32 -1
101 -4.8 0 -1
101 -4.8 -0.32 -1
101 -4.8 -0.64 -1
101 -4.8 -0.96 -1
101 -4.8 -1.28 -1
101 -4.8 -1.6 -1
101 -4.8 -1.92 -1
101 -4.8 -2.24 -1
101 0.96 2.56 -1
101 -3.84 -1.28 -1
101 -3.84 -1.6 -1
101 -3.52 -1.6 -1
101 -3.2 -1.6 -1
101 -2.88 -1.6 -1
101 -2.56 -1.6 -1
101 -2.24 -1.6 -1
101 -1.92 -1.6 -1
101 -2.88 -1.28 -1
101 -2.56 -1.28 -1
101 -1.6 -1.6 -1
101 -1.28 -1.6 -1
101 -0.96 -1.6 -1
101 -0.64 -1.6 -1
101 -0.32 -1.6 -1
101 0 -1.6 -1
101 -1.28 -1.28 -1
101 -0.96 -1.28 -1
101 -0.64 -1.28 -1
101 -0.32 -1.28 -1
101 0.32 -1.6 -1
101 0.64 -1.6 -1
101 0.96 -1.6 -1
101 1.28 -1.6 -1
101 1.6 -1.6 -1
101 1.6 -1.28 -1
101 1.28 -1.28 -1
101 0.96 -1.28 -1
101 0.64 -1.28 -1
101 0.32 -1.28 -1
101 1.92 -1.28 -1
101 1.92 -1.6 -1
101 2.24 -1.6 -1
101 2.56 -1.6 -1
101 2.88 -1.6 -1
101 3.52 -1.28 -1
101 3.52 -0.96 -1
101 3.84 -1.28 -1
101 3.84 -1.6 -1
101 3.84 -0.96 -1
101 3.2 -1.6 -1
101 3.2 -1.28 -1
101 2.88 -1.28 -1
101 2.56 -1.28 -1
101 2.24 -1.28 -1
101 2.24 -0.96 -1
101 2.56 -0.96 -1
101 2.88 -0.96 -1
101 3.2 -0.96 -1
101 1.92 -0.96 -1
101 2.24 -0.64 -1
101 2.56 -0.64 -1
101 2.88 -0.64 -1
101 3.2 -0.64 -1
101 3.52 -0.64 -1
101 3.52 -0.32 -1
3 0 -1.28 0
101 3.84 -0.64 -1
101 3.52 -1.6 -1
